111111111111111111111111111111111111111111111111111111111111111111111111111
1E0000000000000C00000C000000000000000000001C1C1C1C1C1C1C000000000C00C0C0001
101001010010000010100100000001010000000000000000000000000000000000000000001
100001001010101000100100000001011111000000001C1C000000000001C1C000001CC0001
1P0000000C00C0000000000000000000C0C0C0C0C000000000000000C0C0C0C0C0000000001
100000000000000000000C000000000000000000000C0C0C0C00010000C0C0C0C00000C0C01
10100101001000001010010000000101000000000001010010000101000000000111CC00001
100001001010101000100100000001011111001010101000100100001011000010111CC0001
10100101001000001010010000000101000000000001010010000000101000000111CC00001
100001001010101000100100000001011111001010101000100100000001010010111CC0001
111111111111111111111111111111111111111111111111111111111111111111111111111