111111111111111
1000000000000C1
10EC000P01C1001
100000000101001
10000C000101011
10000C0000000C1
111111111111111